R 1366 768
NO ./textures/NO.xpm
SO ./textures/SO.xpm
WE ./textures/WE.xpm
EA ./textures/EA.xpm
S ./textures/devo4ka.xpm
F  60,60,60 
C  100,140,220
        1111111111111111111111111
        1000000000110000000000001
        1011000001110000000550001
        1001000000000000000000001
111111111011000001110000000000001
100000000011000001110111010111111
11110111111111011100000015001
11110111111111011101010010001
11000000110101011100000010001
10002000000000001100000010001
10000000000000001101010010001
11000001110101011111011110N01
11110111 1110101 101111010001
11111111 1111111 111111111111