

222222222222222222222222222222
202000220000022000200022222222
202000220000022000200022222222
202000220000022000200022222222
202202222220022202220222222222
2E0000002220022000000020002222
202202202220022000000000002222
202000202220022000000020002222
202000200000000000000022222222
202000202222222000000020000022
202222202000222000000000002022
222222202020222000000020002022
200000000020222222222222222022
202222202020202000000020000022
202002202000202020202020202022
202002202222202000000020000022
202202000200002000000020000022
202202000200002000000020202022
200002222200002000000020000022
202222222200202222022222202222
200000000000000000022222202222
222222222222222222222222202222
