R 1366 768
NO ./textures/NO.xpm
SO ./textures/SO.xpm
WE ./textures/WE.xpm
EA ./textures/EA.xpm
S ./textures/skeleton1.xpm
F  100,20,20 
C  170,220,255
        1111111111111111111111111
        1000000000110000000000021
        1011000001110000000000021
        1001000000000000000000021
111111111011000001110000000000021
100000000011000001110111010111111
11110111111111011100000012021
11110111111111011101010010001
11000000110101011100000010001
10002000000000001100000010001
10000000000000001101010010001
11000001110101011111011110N011
11110111 1110101 101111012021
11111111 1111111 111111111111