R 1200 1158
NO ./textures/NO.xpm
SO ./textures/SO.xpm
WE ./textures/WE.xpm
EA ./textures/EA.xpm
S ./textures/table1.xpm
F 220,100,0
C 225,30,0
1111111111111111111111111
1000000000000000000000001
1010000000000000000000101
1000000000002000000000001
1000000000000000000000001
100000000000N000000000001
1000000000000000000000001
1000000000002000000000001
1010000000000000000000101
1000000000000000000000001
1111111111111111111111111